RRRRRRRRRRRRRRRRRRRRRRRRRRRRRRRRRRRRRRRRRRRRRRRRRR
RGGGGGGGGGGGGGGGGGGGGGGGGGGGGGGGGGGGGGGGGGGGGGGGGR
RGGGGXGXGGGGGGGGGGGGGGGGGGGGGGGGGGGGGGGGGGGGGGGGGR
RGGGXGGGXGGGGGGGGGGGGGGGGGGGGGGGGGGGGGGGGGGGGGGGGR
RGGGXGGGGGGGGGGGGGGGGGGGGGGGGGGGGGGGGGGGGGGGGGGGGR
RGGGXGGGXGGGGGGGGGGGGGGGGGGGGGGGGGGGGGGGGGGGGGGGGR
RGGGGXXXGGGGGGGGGGGGGGGGGGGGGGGGGGGGGGGGGGGGGGGGGR
RGGGGGGGGGGGGGGGGGGGGGGGGGGGGGWWWGGGGGGGGGGGGGGGGR
RGGGGGGGGGGGGGGGGGGGGGGGGGGGGGGGGGGGGGGGGGGGGGGGGR
RGGGGGGGGGGGGGGGGGGGGGGGGGGWWGGGGGGGGGGGGGGGGGGGGR
RGGGGGGGGGGGGGGGGGGGGGGWWWWWWGGGGGGGGGGGGGGGGGGGGR
RGGGGGGGGGGGGGGGGGGGGGGGGWWWGGGGGGGGGGGGGGGGGGGGGR
RGGGGGGGGGGGGGGGGGGGGGGGGGGGGGGGGGGGGGGGGGGGGGGGGR
RGGGGGGGGGGGGGGGGGGGGGGGGGGGGGGGGGGGGGGGGGGGGGGGGR
RGGGGGGGGGGGGGGGGGGGGGGGGGGGGGGGGGGGGGGGGGGGGGGGGR
RGGGGGGGGGGGGGGGGGGGGGGGGGGGGGGGGGGGGGGGGGGGGGGGGR
RGGGGGGGGGGGGGGGGGXXXXXGGGGGGGGGGGGGGGGGGGGGGGGGGR
RGGGGGGGGGGGGGGGGGGGGGGGGGGGGGGGGGGGGGGGGGGGGGGGGR
RGGGGGGGGGGGGGGGGGGGGGGGGGGGGGGGGGGGGGGGGGGGGGGGGR
RGGGGGGGGGGGGGGGGGGGGGGGGGGGGGGGGXXXGGGGGGGGGGGGGR
RGGGGGGGGGGGGGGGGGGGGGGGGGGGGGGGGWWWWWGGGGGGGGGGGR
RGGGGXXXXXGGGGGGGGGGGGGGWGGGGGGGGGXXXXGGGGGGGGGGGR
RGGGGGGGGGGGGGGGGGGGGGGWWWGGGGGGGGGGGGGGGGGGGGGGGR
RGGGGGGGGGGGGGGGGGGGGGWWWWWGGGGGGGGGGGGGGGGGGGGGGR
RGGGGGGGGGGGGGGGGGGGGWWWWWWWGGGGGGGGGGGGGGGGGGGGGR
RGGGGGGGGGGGGGGGGGGGGGWWWWWGGGGGGGGGGGGGGGGGGGGGGR
RGGGGGGGGGGGGGGGGGGGGGGWWWGGGGGGGGGGGGGGGGGGGGGGGR
RGGGGGGGGGGGGGGGGGGGGGGGWGGGGGGGGGGGGGGGGGGGGGGGGR
RGGGGGGGGGGGGGGGGGGGGGGGGGGGGGGGGGGGGGGGGGGGGGGGGR
RGGGGGGGGGGGGGGGGGGGGGGGGGGGGGGGGGGGGGGGGGGGGGGGGR
RGGGGGGGGGGGGGGGGGGGGGGGGGGGGGGGGGGGGGGGGGGGGGGGGR
RGGGGGGGGGGGGGGGGGGGGGGGGGGGGGGGGGGGGGGGGGGGGGGGGR
RGGGGGGGGGGGGGGGGGGGGGGGGGGGGGGGGGGGGGGGGGGGGGGGGR
RGGGGGGGGGGGGGGGGGGGGGGGGGGGGGGGGGGGGGGGGGGGGGGGGR
RGGGGGGGGGGGGGGGGGGGGGGGGGGGGGGGGGGGGGGGGGGGGGGGGR
RGGGGGGGGGGGGGGGGGGGGGGGGGGGGGGGGGGGGGGGGGGGGGGGGR
RGGGGGGGGGGGGGGGGGGGGGGGGGGGGGGGGGGGGGGGGGGGGGGGGR
RGGGGGGGGGGGGGGGGGGGGGGGGGGGGGGGGGGGGGGGGGGGGGGGGR
RGGGGGGGGGGGGGGGGGGGGGGGGGGGGGGGGGGGGGGGGGGGGGGGGR
RGGGGGGGGGGGGGGGGGGGGGGGGGGGGGGGGGGGGGGGGGGGGGGGGR
RGGGGGGGGGGGGGGGGGGGGGGGGGGGGGGGGGGGGGGGGGGGGGGGGR
RGGGGGGGGGGGGGGGGGGGGGGGGGGGGGGGGGGGGGGGGGGGGGGGGR
RGGGGGGGGGGGGGGGGGGGGGGGGGGGGGGGGGGGGGGGGGGGGGGGGR
RGGGGGGGGGGGGGGGGGGGGGGGGGGGGGGGGGGGGGGGGGGGGGGGGR
RGGGGGGGGGGGGGGGGGGGGGGGGGGGGGGGGGGGGGGGGGGGGGGGGR
RGGGGGGGGGGGGGGGGGGGGGGGGGGGGGGGGGGGGGGGGGGGGGGGGR
RGGGGGGGGGGGGGGGGGGGGGGGGGGGGGGGGGGGGGGGGGGGGGGGGR
RGGGGGGGGGGGGGGGGGGGGGGGGGGGGGGGGGGGGGGGGGGGGGGGGR
RGGGGGGGGGGGGGGGGGGGGGGGGGGGGGGGGGGGGGGGGGGGGGGGGR
RRRRRRRRRRRRRRRRRRRRRRRRRRRRRRRRRRRRRRRRRRRRRRRRRR
